5,5,5,5,5,5,5,5,5,5,5,5,5,5,5,5,5,5,5,5,5,5,5,5,5,5,5,5,5,5,5,5,5,5,5,5,5,5,5,5,5,5
5,5,10,10,10,10,10,10,10,10,10,10,10,10,10,10,5,5,5,5,10,10,10,10,10,1,5,5,5,5,5,5,5,5,5,5,5,5,5,5,5,5
5,5,10,0,0,0,0,0,10,0,0,0,0,0,0,10,5,5,5,5,10,0,0,0,5,1,5,5,5,10,10,10,10,10,10,10,10,10,10,10,5,5
5,5,10,0,0,0,0,0,10,0,0,0,0,0,0,10,10,10,10,10,10,0,0,1,1,1,5,5,5,10,5,5,5,5,5,5,5,5,5,10,5,5
5,5,10,0,0,10,0,0,10,0,0,0,10,0,0,10,0,0,0,0,5,0,0,1,1,1,5,5,5,10,5,5,5,3,3,3,5,5,5,10,5,5
5,5,10,10,10,10,10,10,10,10,10,10,10,10,10,10,10,0,0,0,5,0,0,0,5,1,5,5,5,10,5,5,5,3,3,3,5,5,5,10,5,5
5,5,10,3,3,3,3,3,3,3,3,3,3,3,3,10,10,0,0,0,5,5,5,5,5,1,5,5,5,10,5,5,5,3,3,3,5,5,5,10,5,5
5,5,10,3,3,3,3,3,3,3,3,3,3,3,3,10,0,0,0,0,5,0,0,0,5,1,5,5,5,10,5,5,5,3,3,3,5,5,5,10,5,5
5,5,10,3,3,3,3,5,5,5,5,3,3,3,3,10,10,10,10,10,10,0,0,0,5,1,5,5,5,10,5,5,5,5,5,5,5,5,5,10,5,5
5,5,10,3,3,3,3,5,5,5,5,3,3,3,3,10,5,5,5,5,10,0,0,1,1,1,5,5,5,10,10,10,10,10,10,10,10,10,10,10,5,5
5,5,10,3,3,3,3,5,5,5,5,3,3,3,3,10,5,5,5,5,10,0,0,0,5,1,5,5,5,5,5,5,5,5,10,5,5,5,5,5,5,5
5,5,10,3,3,3,3,3,3,3,3,3,3,3,3,10,5,5,5,5,10,0,0,0,5,1,5,5,5,5,5,5,5,5,10,5,5,5,5,5,5,5
5,5,10,3,3,3,3,3,3,3,3,3,3,3,3,10,5,5,5,5,10,5,5,5,5,1,5,5,5,5,5,5,5,5,10,5,5,5,5,5,5,5
5,5,10,10,10,10,10,10,10,10,10,10,10,10,10,10,1,1,1,1,1,1,1,1,1,1,1,1,1,1,1,1,1,1,1,1,1,1,1,1,1,1
5,5,1,5,5,5,5,5,5,5,5,5,5,5,5,1,5,5,5,5,5,5,5,5,5,1,5,5,5,5,5,5,5,5,5,5,5,5,5,5,5,5
5,5,1,5,0,0,0,5,5,0,0,0,0,5,5,1,5,0,0,0,0,0,0,0,5,1,5,0,0,0,0,0,0,0,5,0,0,0,0,0,5,5
5,5,1,10,10,0,0,5,5,0,0,0,1,1,1,1,5,0,0,0,0,0,0,0,5,1,5,0,0,0,0,0,0,0,5,0,0,0,0,0,5,5
5,5,1,5,0,0,0,5,5,0,0,0,0,5,5,1,5,0,1,0,0,0,1,0,5,1,5,0,0,0,0,1,0,0,5,0,0,1,0,0,5,5
5,5,1,5,5,5,5,5,5,5,5,5,5,5,5,1,5,5,1,5,5,5,1,5,5,1,5,5,5,5,5,1,5,5,5,5,5,1,5,5,5,5
5,5,1,1,1,1,1,1,1,1,1,1,1,1,1,1,1,1,1,1,1,1,1,1,1,1,1,1,1,1,1,1,1,1,1,1,1,1,1,1,5,5
5,5,1,10,10,10,10,10,10,1,5,5,5,5,5,5,5,5,5,5,1,5,5,5,1,5,5,5,5,5,1,5,5,1,5,10,5,5,5,1,5,5
5,5,1,10,0,0,0,0,10,1,5,0,0,0,5,5,0,0,0,5,1,5,0,0,1,0,5,0,0,5,1,5,0,1,0,10,0,0,5,1,5,5
5,5,1,10,0,0,0,0,10,1,5,0,0,0,5,5,0,0,1,1,1,5,0,0,0,0,5,0,0,5,1,5,0,0,0,10,0,0,5,1,5,5
5,5,1,10,0,0,0,10,10,1,1,1,0,0,5,5,0,0,0,5,1,5,5,5,5,5,5,0,1,1,1,5,5,5,5,10,0,1,1,1,5,5
5,5,1,10,0,0,0,0,10,1,5,0,0,0,5,5,0,0,0,5,1,5,0,0,0,0,5,0,0,5,1,5,0,0,0,10,0,0,5,1,5,5
5,5,1,10,0,0,0,0,10,1,5,0,0,0,5,5,0,0,0,5,1,5,0,0,1,0,5,0,0,5,1,5,0,1,0,10,0,0,5,1,5,5
5,5,1,10,10,10,10,10,10,1,5,5,5,5,5,5,5,5,5,5,1,5,5,5,1,5,5,5,5,5,1,5,5,1,5,10,5,5,5,1,5,5
5,5,1,1,1,1,1,1,1,1,1,1,1,1,1,1,1,1,1,1,1,1,1,1,1,1,1,1,1,1,1,1,1,1,1,1,1,1,1,1,5,5
5,5,1,5,5,5,5,5,5,5,5,1,5,5,5,5,10,5,1,5,10,5,5,5,10,5,1,5,5,5,1,5,5,5,5,10,5,5,5,1,5,5
5,5,1,5,0,0,0,0,0,0,5,1,5,0,0,0,10,0,1,0,10,0,0,0,10,0,1,0,5,5,1,5,0,0,0,10,0,0,5,1,5,5
5,5,1,5,0,0,1,1,0,0,5,1,5,0,1,0,10,0,0,0,10,0,1,0,10,0,0,0,5,5,1,5,0,0,0,0,0,0,5,1,5,5
5,5,1,5,5,5,1,1,5,5,5,1,5,5,1,5,10,5,5,5,10,5,1,5,10,5,5,5,5,5,1,5,5,5,5,5,5,5,5,1,5,5
5,5,1,1,1,1,1,1,1,1,1,1,1,1,1,1,1,1,1,1,1,1,1,1,1,1,1,1,1,1,1,1,1,1,1,1,1,1,1,1,5,5
5,5,1,5,5,5,5,5,5,5,5,5,5,5,5,5,5,5,5,5,1,5,5,5,5,5,5,10,5,5,5,5,5,5,1,10,10,10,10,1,5,5
5,5,1,5,0,0,0,0,0,0,0,0,0,0,0,0,0,0,0,5,1,5,5,5,5,5,5,10,5,5,5,5,5,5,1,10,0,0,10,1,5,5
5,5,1,5,0,1,1,1,1,1,1,1,0,0,1,1,1,0,0,5,1,5,5,5,5,5,5,10,5,5,5,5,5,5,1,10,0,0,10,1,5,5
5,5,1,5,0,1,0,0,0,0,0,1,0,0,0,0,1,0,0,5,1,10,10,10,10,10,10,10,10,10,10,10,10,10,1,10,10,0,10,1,5,5
5,5,1,5,0,1,1,1,1,0,0,1,1,1,1,1,1,0,0,5,1,5,5,5,5,5,5,10,5,5,5,5,5,5,1,10,0,0,10,1,5,5
5,5,1,5,0,0,0,0,1,0,0,0,0,0,0,0,0,0,0,5,1,5,5,5,5,5,5,10,5,5,5,5,5,5,1,10,0,0,10,1,5,5
5,5,1,5,0,0,0,0,1,0,0,0,0,0,0,0,0,0,0,5,1,5,5,5,5,5,5,10,5,5,5,5,5,5,1,10,10,10,10,1,5,5
5,5,1,1,1,1,1,1,1,1,1,1,1,1,1,1,1,1,1,1,1,1,1,1,1,1,1,1,1,1,1,1,1,1,1,1,1,1,1,1,5,5
5,5,5,5,5,5,5,5,5,5,5,5,5,5,5,5,5,5,5,5,5,5,5,5,5,5,5,5,5,5,5,5,5,5,5,5,5,5,5,5,5,5
